[
	[0, 8, 0, 8, 0, 8, 0, 8, 0, 8, 0, 8, 0, 8, 0, 8],
	[8, 1, 8, 1, 8, 1, 8, 1, 8, 1, 8, 1, 8, 1, 8, 1],
	[1, 8, 2, 8, 2, 8, 2, 8, 2, 8, 2, 8, 2, 8, 2, 8],
	[8, 2, 8, 3, 8, 3, 8, 3, 8, 3, 8, 3, 8, 3, 8, 2],
	[1, 8, 3, 8, 4, 8, 4, 8, 4, 8, 4, 8, 4, 8, 3, 8],
	[8, 2, 8, 4, 8, 5, 8, 5, 8, 5, 8, 5, 8, 4, 8, 2],
	[1, 8, 3, 8, 5, 8, 6, 8, 5, 8, 6, 8, 5, 8, 3, 8],
	[8, 2, 8, 4, 8, 6, 8, 7, 8, 7, 8, 6, 8, 4, 8, 2],
	[1, 8, 3, 8, 5, 8, 7, 8, 7, 8, 7, 8, 5, 8, 3, 8],
	[8, 2, 8, 4, 8, 6, 8, 7, 8, 7, 8, 6, 8, 4, 8, 2],
	[1, 8, 3, 8, 5, 8, 6, 8, 5, 8, 6, 8, 5, 8, 3, 8],
	[8, 2, 8, 4, 8, 5, 8, 5, 8, 5, 8, 5, 8, 4, 8, 2],
	[1, 8, 3, 8, 4, 8, 4, 8, 4, 8, 4, 8, 4, 8, 3, 8],
	[8, 2, 8, 3, 8, 3, 8, 3, 8, 3, 8, 3, 8, 3, 8, 2],
	[1, 8, 2, 8, 2, 8, 2, 8, 2, 8, 2, 8, 2, 8, 2, 8],
	[8, 1, 8, 1, 8, 1, 8, 1, 8, 1, 8, 1, 8, 1, 8, 1],
	[7, 8, 7, 8, 7, 8, 7, 8, 7, 8, 7, 8, 7, 8, 7, 8],
]

//0-OneHit,
//1-TwoHit,
//2-ThreeHit,
//3-FourHit,
//4-FiveHit,
//5-SixHit,
//6-Indestructible,
//7-PowerUP,
//8-None,