[
	[0, 0, 0, 0, 0, 0, 0, 0, 0, 0, 0, 0, 0, 0, 0, 0],
	[0, 0, 0, 0, 0, 0, 1, 1, 1, 1, 0, 0, 0, 0, 0, 0],
	[0, 0, 0, 0, 0, 1, 2, 2, 2, 2, 1, 0, 0, 0, 0, 0],
	[0, 0, 0, 0, 1, 2, 3, 3, 3, 3, 2, 1, 0, 0, 0, 0],
	[0, 0, 0, 1, 2, 3, 4, 4, 4, 4, 3, 2, 1, 0, 0, 0],
	[0, 0, 1, 2, 3, 4, 5, 5, 5, 5, 4, 3, 2, 1, 0, 0],
	[0, 1, 2, 3, 4, 5, 5, 5, 5, 5, 5, 4, 3, 2, 1, 0],
	[1, 2, 3, 4, 5, 5, 5, 7, 7, 5, 5, 5, 4, 3, 2, 1],
	[1, 2, 3, 4, 5, 5, 5, 7, 7, 5, 5, 5, 4, 3, 2, 1],
	[0, 1, 2, 3, 4, 6, 5, 5, 5, 5, 6, 4, 3, 2, 1, 0],
	[0, 0, 1, 2, 3, 4, 6, 6, 6, 6, 4, 3, 2, 1, 0, 0],
	[0, 0, 0, 1, 2, 3, 4, 6, 6, 4, 3, 2, 1, 0, 0, 0],
	[0, 0, 0, 0, 1, 2, 3, 4, 4, 3, 2, 1, 0, 0, 0, 0],
	[0, 0, 0, 0, 0, 1, 2, 3, 3, 2, 1, 0, 0, 0, 0, 0],
	[0, 0, 0, 0, 0, 0, 1, 2, 2, 1, 0, 0, 0, 0, 0, 0],
	[0, 0, 0, 0, 0, 0, 0, 1, 1, 0, 0, 0, 0, 0, 0, 0],
]

//0-OneHit,
//1-TwoHit,
//2-ThreeHit,
//3-FourHit,
//4-FiveHit,
//5-SixHit,
//6-Indestructible,
//7-PowerUP,
//8-None,